MMMMMMMMMMMMMMMMMMMMMMMMMMMMMMMMMMMMMMMMMMMMMMMMMMMMMMMMMMMMMMMMMMMMMMMMMMMMMMMMMMMMMMMMMMMMMMMMMMMMMMMMMMMMMMMMMMMMMMMMMMMMMMM
MMMMMMMMMMMMMMMMMMMMMMMMMMMMMMMMMMMMMMMMMMMMMMMMMMMMMMMMMMMMMMMMMMMMMMMMMMMMMMMMMMMMMMMMMMMMMMMMMMMMMMMMMMMMMMMMMMMMMMMMMMMMMMM
M                                                                                                                             M
M                                                                                                                             M
M                                                                                                                             M
M                                                                                                                             M
M                                                                                                                             M
M                                                                                                                             M
M                                                                                   MMM                                       M
M                                                                                                                             M
M                   G                                                                                                         M
M                  MMMM                                                           MMMMMM                                      M
M                                                    M                                                                        M
M                                              M     M                                                                        M
M         M          G                 M       M     M                      G                                                 M
SSSSSSSSSSSSSSSSSSSSSSSSSSSSSSSSSSSSSSSSSSSSSSSSSSSSSSSSSSSSSSSSS  SSSSSSSSSSSSSSSSSSSSSSSSSSSSSSSSSSSSSSSSSSSSSSSSSSSSSSSSSSSS