MMMMMMMMMMMMMMMMMMMMMMMMMMMMMMMMMMMMMMMMMMMMMMMMMMMMMMMMMMMMMMMMMMMMMMMMMMMMMMMMMMMMMMMMMMMMMMMMMMMMMMMMMMMMMMMMMMMMMMMMMMMMMMM
MMMMMMMMMMMMMMMMMMMMMMMMMMMMMMMMMMMMMMMMMMMMMMMMMMMMMMMMMMMMMMMMMMMMMMMMMMMMMMMMMMMMMMMMMMMMMMMMMMMMMMMMMMMMMMMMMMMMMMMMMMMMMMM
M                                                                                                                             M
M                                                                                                                             M
M                                                                                                                             M
M                                                                                                                             M
M                                                                                                                             M
M                                                                                                                             M
M                                                                                                          M                  M
M                                                                                                          M                  M
M                   G                                           M                                          M  G               M
M                  MMMM                                        MM        M                                 MMMMMMMMM          M
M                                              MMM            MMM        M                                                    M
M                                                            MMMM        M                                                    M
M         M                              G                  MMMMM        M                                                    M
SSSSSSSSSSSSSSSSSSSSSSSSSSSSSS   SSSSSSSSSSSSSS   SSSSSSSSSSSSSSS        SSSSSSSSSSSSSSSSSSSSSSSSSSSSSSSSSSSSSSSSSSSSSSSSSSSSSS